8 5
0 3 0 0 0 0 0 0
0 0 0 0 0 0 0 0
0 3 0 0 0 0 0 0
0 6 0 2 0 0 0 0
0 2 0 0 0 0 0 0
